0000000000000000000000000000000000000000000000000000000000000000
0000000000000000000000000000000000000000000000000000000000000000
0000000000000000000000000000000000000000000000000000000000000000
0000000000000000000000000000000000000000000000000000000000000000
0000000000000000000000000000000000000000000000000000000000000000
0000000000000000000000000000000000000000000000000000000000000000
0000000000000000000000000000000000000000000000000000000000000000
0000000000000000000000000000000000000000000006000000060000000000
0000000000000000000000000000000000000000000001000000010000000000
0000000000000000000000000000000000000000000000000000000000000000
0000001000000100404010000500010000500000000000000000000000000000
1111111222222111111111111111111111111111111111111111111111113333