0000000000000000000000000000000000000000000000000000000000000000
0000000000000000000000000000000000000000000000000000000000000000
0000000000000000000000000000000000000000000000000000000000000000
0000000000000000000000000000000000000000000000000000000000000000
0000000000000000000000000000000000000000000000060000000600000000
0000000000000000000000000000000000000000000000010000000100000000
0000000000000000000600000000000000000000000000000000000000000000
0000000000000000000100000000000000000000000000000000000000000000
0000000000000000000000000000000000000000050010401000010401000000
0000000000000000000000000000000000001100010011111000011111000333
0000000014010000000500001000500050000000000000000000000000000000
1111122211112221111111111111111111122222222222222222222222222222