0000000000000000000000000000000000000000000000000000000000000000
0000000000000000000000000000000000000000000000000000000000000000
0000000000000000000000000000000000000000000000000000000000000000
0000000000000000000000000000000000000000000000000000000000000000
0000000000000001040000410000000000000000000006000000000060000000
0000000000011000111111100000000000000000000001000000000010000000
0000000000000000000000000000000000000000000000000500000000000000
0000000011000000000000000000000000000000000000001111000000000000
0000000000000000000000000000000000000010000000000000000000111111
0000001100000000000000000000000000000000000000000000000000500050
0000000000000001000004000010000000011000000000000000000000500050
1111222222222221111111111111111111111222221111111111111111111333