0000000000000000000000000000000000000000000000000000000000000000
0000000000000000000000000000000000000000000000000000000000000000
0000000000000000000000000000000000000000000000000000000000000000
0000000000000000000000000000000000000000000000000000000000000000
0000000000000000000000000000000000000000000000000000000000000000
0000000000000000000000000000000000000000000000000000000000000000
0000000000000000000000000000000070000000000000000000000000000000
0000000000000011000000000000000000000000000000000000000000000000
0000000000000000000000000000001111000000000000000000000000000000
0000000001100000000000000000000000000000000000000000000000000000
0000000000000000000000000000000000000000000000000000000000000000
2222222222221111111111111111112222222222222200000000000000000000